**********
..****...*
.*.....*.*
..*.***...
*....****.
...*..***.
@****....X
