**.....***
*..***.*.X
**...*...*
*.**.**.**
*....**.**
*.**...***
*.**@*.***
