*******
*...*..
*.***.*
*..*..*
**...**
***.***
*...***
X.*...@
