******
*....*
**.*.*
**.*X*
**@***
